10
15
0001011001
1000001000
0000000000
0010000000
0000000001
0000000000
0000000000
0000000000
0000100000
0000100000
0001000000
0010100000
0001000000
0000000100
0000000000
