10
15
0001011001100010
1000001000010000
0000000000000100
0010000000001000
0000000001000000
0000100000000000
0000000000100000
0000000010000000
0000100000000001
0000100000010000
0001000000000000
0010100000000000
0001000000000000
0000000100000000
0000000000000000
