10
15
0001011001
1000001000
0100000100
0010000010
0000100001
0001000100
0100000010
0010001000
0001100000
0000100100
